xxxxxxxxxxxxx
x--p-----p--x
xxx-------xxx
xx---xxx---xx
x-----------x
x----xxx----x
x-----x-----x
x-x-------x-x
xxxxxxxxxxxxx